12X15
###############
#oo#          #
#  # #      o##
#    @        #
#             #
##@     #     #
#       #  @  #
#       #     #
#   @   #     #
#       #   A #
#      o#     #
###############