8X8
########
#A@   o#
#@@  ###
# #   o#
# #    #
# # @# #
#o#  #o#
########