12X15
###############
#o#           #
# #@       #  #
# #      #o#  #
# #      #o#  #
#        # #  #
#       o# #  #
# ######## ####
#@@     @  @ o#
# ## ##### #  #
#            A#
###############