6X8
########
# A    #
# @  ###
# o@o###
#  @  o#
########