5X5
#####
#  A#
# @ #
# o #
#####
