15X12
###############
#oo#          #
#  # #      o##
#    @        #
##@           #
#       #     #
#       #  @  #
#       #     #
#   @   #     #
#       #   A #
#      o#     #
###############